la laurea triennale - el grado
in qualche modo sì - de alguna manera sí
la storia - la historia
metto in pausa - pongo en pausa
ho riflettuto su questo - reflexioné en esto
cose in eccesso - cosas en exceso
oltre a - además de
ti chiamano all'impazzata - te llaman a lo loco
non è più una pazzia di gruppo - ya no es una locura de grupo
tantissimo tempo fa - hace muchísimo tiempo
un paio di volte - un par de veces
qualche volta - a veces
mi rendo conto - me doy cuenta
romanesco - de Roma
un burino - un cateto
un pò volgare - un poco vulgar
un esame - un examen
dal momento che - ya que
visto che - visto que
siccome - como
mi sono svegliato tardi - me levanté tarde
ero addormentato - me dormí
non mi sono accorto - no me he dado cuenta
il cristallo - el cristal
per quanto riguarda tutte - en cuanto a todos
le cose - las cosas
un buon equilibrio - un buen equilibrio
anch'io - yo también
dopo molti - después de muchos
anni - años
tutte le cose che sono successe - todas las cosas que han pasado
da dopo la scuola - de después de la escuela
il fidanzato - el novio
la fidanzata - la novia
ho appena finito di leggere - apenas acabo de leer
spiegarsi - explicarse
ho sottolineato - he subrayado
la volpe - el zorro
ho pranzato - he comido
pranzare - comer
ho fatto colazione - he comido
sono uscito - he salido
un paio di volte - un par de veces
50 metri da qui - a 50 metros de aquí
è vicino - está cerca
ci sono tante cose - hay tantas cosas
che si possono comprare - que se pueden comprar
c'è tanta frutta - hay tanta fruta
i vestiti - los vestidos
congelatore - congelador
è la parte di sopra - es la parte de arriba
ha potuto - ha podido
2 anni fa - hace 2 años
3 ore fa - hace 3 horas
Islanda - Islandia
un bel viaggio - un bello viaje
non ero andato mai prima - no he ido nunca antes
in quest'isola - en esta isla
mi sono reso conto - he di cuenta
abbiamo visto molte cascate - hemos visto muchas cascadas
c'era tanto fumo che usciva - había tanto humo que salía
dalla terra - de la tierra
a 400 km - a 400 km
ci siamo resi conto - nos dimos cuenta
era una battuta - era una broma
il pancarré - el pan de molde
ci sei? - ¿estás ahí?
io ed i miei amici - yo y mis amigos
abbiamo celebrato nel centro della - hemos celebrado en el centro de la
città - ciudad
nel mio appartamento - en mi apartamento
i miei fratelli - mis hermanos
sono venuti - vinieron
sono partiti - se fueron
genitori - padres
ce l'ho qui - lo tengo aquí
lui cerca di - él intenta
accendere - encender
lampada - lámpara
sul comodino - sobre la mesita de noche
mi sono reso conto - me he dado cuenta
nel corridoio - en el pasillo
lui va - él va
verso la cucina - hacia la cocina
lui se lo strofina in faccia - él se lo frota en la cara
lui mette i piatti nella lavatrice - él mete los platos en la lavadora
aprire il rubinetto - abrir el grifo
si spoglia - se desnuda
spogliarsi - desnudarse
lui esce - él sale
appena lui apre la porta - apenas él abre la puerta
si rendono conto - se dan cuenta
i vicini se ne rendono conto - los vecinos se dan cuenta
buttare un secchio d'acqua - tiran un cubo de agua
addosso - encima
siamo entrati - hemos entrado
provo a ripetere - intento repetir
lui stava dormendo - él estaba durmiendo
mi sono reso conto che lui stava dormendo - me he dado cuenta de que él estaba durmiendo
lui è andato - él se ha ido
che non capivo - que no entendí
di latte - de leche
lui se l'è spalmata - él se la ha extendido
si è seduto - se ha sentado
si è spogliato - se ha desnudado
spogliarsi - desnudarse
i vicini se ne sono resi conto - los vecinos se dieron cuenta
arrabbiata - enfadada
si è arrabbiata - se ha enfadado
ha buttato un secchio addosso al mio amico - ha tirado un cubo encima de mi amigo
sta chiamando l'ascensore - está llamando al ascensor
tirare uno schiaffo - dar una bofetada
immagino - supongo
ubriaco - borracho
il suo amico lo va a visitare in ospedale - su amigo lo va a visitar al hospital
lui cade dalle scale - él cae por las escaleras
sento un'eco - escucho un eco
sento un riverbero - escucho una reverberación
lui cade per terra - él cae al suelo
anzi no - de hecho no
e - y
Capodanno - noche vieja
ho nuotato - he nadado
proposto - propuesto
assistente di volo - asistente de vuelo
cioè - es decir
ossia - osea
infatti - de hecho
contento - contento
comodo - comodo
carico - cargado
carica - cargada
fortunato - afortunado
fortunata - afortunada
gonfio - hinchado
gonfia - hinchada
leale - leal
coperto - cubierto
garbato - educado
garbata - educada
fiorito - florido
cortese - cortés
piacevole - placentero
gradito - gustado
colorito - colorido
gradevole - agradable
pettinato - peinado
scomodo - incómodo
scarico - sin batería
sfortunato - desafortunado
sgonfio - deshinchado
sleale - desleal
sgarbato - maleducado
sconfinato - ilimitado
scortese - descortés
spiacevole - desafortunado
sgradito - no deseado
sgradevole - desagradable
spettinato - desarreglado
sponsorizzato - esponsorizado
da vedere insieme - para ver juntos
di gran lunga - con diferencia
azienda - compañía
in fin dei conti - después de todo
alla fin fine - al fin y al cabo
tanto vale - más vale
prima o poi - tarde o temprano
non vedere l'ora di - no puedo esperar a
una sorta di - una especie de
se non altro - al menos
seccata - enfadada
sembrava - parecía
per lo meno - por lo menos
detto ciò - dicho esto
come nessun altro - como ningún otro
asterisco - asterisco
senza pari - sin igual
nell'arco di - en el plazo de
nel giro di 2 anni - dentro de 2 anni
sempre di più - cada vez más
sempre di meno - cada vez menos
meno male - menos mal
ogni giorno che passa - cada día que pasa
ogni due giorni - cada dos días
ad alta voce - en voz alta
stufi - hartos
stufo - harto
bolletta - factura
mi raccomando - recomiendo
falla finita! - ya basta!
finiscila! - basta!
litigare - pelear
infastidito - fastidiado
espressioni - expresiones
colloquiali - coloquiales
utili - útiles
conversazione - conversación
fammi el favore! - venga ya!
speriamo bene! - toco madera!
incrocio le dita - cruzo los dedos
non è male - no está mal
ma figurati! - no me tomes el pelo!
essere in grado di - ser capaz de
macché! - qué va!
carnevale - carnaval
paragrafo - párrafo
facile da trovare - fácil de encontrar
risalire - remontarse
risale - se remonta
carri allegorici - carrozas
allegorici - alegórico
operai - trabajadores
cartapesta - papel maché
affrontano - se enfrentan
pungente - mordaz
rappresentando - representando
politici - políticos
oltre a - además de
reionali - regionales
sfilata - desfile
notturna - nocturna
festeggiare - festejar
spettacolari - espectaculares
ditte - empresas
gigantesche - gigantescas
programma - programa
accompagnato - acompañado
visite guidate - vistas guiadas
avviato - empezado
palinsesto - horario
lo sguardo - la mirada
frequentare - asistir
intraprendere - emprender
percorso - recorrido
messo - puesto
produrre - producir
efficenza - eficiencia
responsabilità - responsabilidad
reazione - reacción
colleghi - colegas
vuol dire - significa
impatto - impacto
feci - hice
fui - fui
bocciato - rechazado
approccio - planteamiento
giusto - justo
trasmesso - transmitido
trent'anni - treinta años
messaggio - mensaje
devo dire - tengo que decir
altezza - altura
invecchiano - envejecen
giudicare - juzgar
verso di loro - hacia ellos
ruoli - roles
stima - estima
guadagnare - ganar
amministrativo - administrativo
studenti - estudiantes
peso - peso
posizioni - posiciones
pianificazione - planificación
esigenze - exigencias
sviluppare - desarrollar
dimostra - demuestra
segreto - secreto
crisi - crisis
prendere - adoptar
insediati - establecidas
strumento - instrumento
onesta - honesta
emergenze - emergencias
bloccato - bloqueado
pochino - poquito
ritenuto - considerado
valere la pena - valer la pena
stanchezza - cansancio
aneddoto - anécdota
bagaglio - equipaje
sicuramente - seguramente
nazionalità - nacionalidad
organizzato - organizado
immagini - imágenes
deluso - decepcionado
soddisfazione - satisfacción
difficoltà - dificultad
serietà - seriedad
significativa - significativa
fiducia - confianza
l'equità - la equidad
l'integrità - la integridad
alunni - alumnos
l'anima - el alma
mi dicevi - me decías
ricostruire - reconstruir
grandissima - grandísima
rettore - rector
colpa - culpa
sicuramente - seguramente
garanzia - garantía
famiglia - familia
buttare via - desperdiciar
risorsa - recurso
pigrizia - pereza
successivi - sucesivos
basi - bases
opportunità - oportunidad
progetto - proyecto
sportiva - deportiva
legate - ligadas
centinaia - centenares
scambio - intercambio
un'altra - otra
accordi - acuerdos
ventaglio - abanico
attenzione - atención
spero - espero
piano - plano
modello - modelo
fruire - disfrutar
ampia - amplia
chiaro - claro
cambiare - cambiar
società - sociedad
scoperto - descubierto
commenti - comentarios
controllare - comprobar
riguarda - se refiere a
tenere a mente - tener en cuenta
economiche - económicas
qualsiasi - cualquier
rimarrete - os quedaréis
ha presso in considerazione - tuvo en cuenta
capoluogo - capital
stilare - establecer
errata - equivocada
classifica - clasificación
è più cara di Roma - es más cara que Roma
perciò - por eso
quartiere - barrio
probabilmente - probablemente
pari a - equivalente a
virgola - coma
annua - anual
inflazione - inflación
mila - mil
eccetto - excepto
fondo - fondo
ovvero - es decir
siete sorpresi? - estáis sorprendidos?
esattamente - exactamente
forse - tal vez
piazzare - colocar
esitare - dudar
auguro - espero
al contempo - al mismo tiempo
pronti, partenza, via - preparados, listos, ya
non ha niente a che vedere con - no tiene nada que ver con
pubblico - público
maggiorenni - mayor de edad
elencare - nombrar
tramezzini - bocadillos
a scelta - a elección
noccioline - cacahuetes
vendita - venta
gratta e vinci - rasca y gana
francobolli - sellos
biglietti - billetes
abbonamenti - abonos
nonché - así como
il quotidiano - el periódico
atmosfera - atmósfera
si sentano - se sientan